111111111111111111111111111111111111111
1CC1CCCCC11111111111111CCCCCCCCCCCCCCC1
1CC1C111C1CCCCCCCCCCCC1C1111C111111CCC1
1CC1CCCCC1CCC1111111CCCCC1CCCCCCC11CCC1
1CC1111C1111C1CCCCC1C111C111C111C11CCC1
1CCCCCCCCCCCC1CCCCC1CCCCC1CCCCC1CCCCCC1
1C1111C1111C1111C111C111C111C111C1111C1
1CCCCCCCCCCCCCCCCCCCCCCCCCCCCCCCCCCCCC1
1C111C1111C11111C111C111C111C111C1111C1
1CCCCCCCCCCCC1CCCCC1CCCCCCCCCCE1CCCCCC1
1CC1111C1111C1111111C111C111C111C11CCC1
1CC1CCCCC1CCCCCCCCCCCCCCC1CCCCCCC11CCC1
1CC1C111C1C111C11111C11111C11111C11CCC1
1CC1CCCCC1CCCCCCCCCCCCCCC1CCCCCCCCCCCC1
1CC1CCCCC1C111111111111CC1C11111111CCC1
1PC1CCCCC1CCCCCCCCCCCCCCCCCCCCCCCCCCCC1
1CC1C11111C111C111111C11C111C111C11CCC1
1CC1CCCCCCCCCCCCCCCCCCCCC1CCCCCCCC1CCC1
1CC1111111111111C111111CC111C111C111CC1
1CCCCCCCCCCCCCCCCCCCCCCCCCCCCCCCCCCCCC1
111111111111111111111111111111111111111
