111111111
100C00001
101111101
1P0000001
101111101
100C000E1
111111111
