111111111
1CCCCECC1
1C11111C1
1CCCCCCC1
1C11111C1
1PCCCCCC1
111111111
