11111111
1CCCCCE1
1C1111C1
1CCCCCC1
1C1111C1
1PCCCCC1
11111111
