11111111
100C0001
1000C001
1P010001
1C000001
10000EC1
11111111
