111111111111
1PCCCCCCCCC1
1C11111111C1
1CCCCECCCCC1
1C11111111C1
1CCCCCCCCCC1
111111111111
