111111111
100C00001
101111101
100000001
101111101
100C00001
111111111