111111111111
100C00000001
101111111101
1P0000000P01
111111111101
1EE0C0000001
111111111111
