111111111111111
1CCCCCCCCCCCCE1
1C111111111C1C1
1CCCCCCPCCCCCC1
1C111111111C1C1
1CCCCCCCCCCCCC1
111111111111111
