111111111
1CCCCCCP1
1C11111C1
1CCCCCCC1
1C11111C1
1ECCCCCC1
111111111
