111111111111111
1000000C0000001
101111111110101
100000000000001
101111111110101
1000000C0000001
111111111111111