111111111111111111111111111111111111111
100100000111111111111110000000000000C01
100101110100000000000010111101111110001
100100000100011111110000010000000110001
100111101111010000010111011101110110001
100000010000010000010000010000010000001
101111011110111101110111011101110111101
100000000000000000000000000000000000001
101110111101111101110111011101110111101
100000000000010000010000000000010000001
100111101111011111110111011101110110001
100100000100000000000000010000000110001
100101110101110111110111110111110110001
100100000100000000000000010000000000001
100100000101111111111110010111111110001
1P0100000100000000000000000000000000001
100101111101110111111011011101110110001
100100000000000000000000010000000110001
100111111111111101111110011101110111001
100000000000000000000000000000000000C01
111111111111111111111111111111111111111