1111111
100C001
1P000E1
100C001
1111111
