11111111
100C0001
1P000E11
101C1111
101C0001
11111111
