1111111
100C111
1P001E1
100C111
1111111
