1111111111111111111111111111111111111111
1P010000000000000000000000000000000000C1
1001000000000000000000000000000000000001
1001000000000000000000000000000000000001
1001000000000000000000000000000000000001
1001000000000000000000000000000000000001
1001000000000000000000000000000000000001
1001000000000000000000000000000000001001
1001000000000000000000000000000000001001
1001000000000000000000000000000000001001
1001000000000000000000000000000000001001
1001000000000000000000000000000000001001
1001000000000000000000000000000000001001
10010000000000000000000000000000000010C1
10010011111111111111111111111111111111C1
10010000000000000000000000000000000000C1
1000011111111111111111111111111111111001
100011E000000000000000000000000000000001
1111111111111111111111111111111111111111
