11111111
10000001
10000001
1P010001
10000001
10000EC1
11111111
