11111111
100C0001
10111101
100C0001
10111101
100C0001
11111111