111111111111
100C00000001
101111111101
100000000001
101111111101
100C00000001
111111111111