111111111111
1000000C0001
101111111101
100000000001
101111111101
1000000C0001
111111111111