1111111111111111111111111111111111111111111
1P0C0E0000000000000000000000000000000000001
1000000000000000000000000000000000000000001
1000000000000000000000000000000000000000001
1000000000000000000000000000000000000000001
1111111111111111111111111111111111111111111
